qsu: gho eva
cmz: lja uug kyc
gab: wqm moj qkc dfi
yiq: ewh zrg
wsc: vyr
tmm: egn zqg ybs
gbv: tgq
eee: vna bhj hws lnz adg yma dqh svy ngn lbp xlp oxd rrn
dlr: irg ssi hck
vjz: wzi
cby: wvi prx
aln: qbx bri dgq dcl dmm txj
frk: rid
fxi: out
slr: hkv mvb
gax: fvr wrg
uzk: gza eee
pzj: wsc dlr
qre: lrd
mui: gih vgm
dac: jjc bea
uug: vwc fsg the tjf xxn
mto: tgc fnv ujb eqh djp
rvo: ojl ggt
kmy: zjj mfh
xqi: dwv
yzb: cmz vcj fmm gga
jjc: tow gyt
zil: zsu awn obg dea zsl aqu iaa abx rht gad orb oeb
qwd: ebj
qvm: gga cmz vcj fmm
oxc: mtc
zch: opy
aos: fwj nkp
daj: oga tay
cvf: sjy
bif: xto
vwd: xtt qan
hli: you
hlb: pyu sna
zfw: puv zyg rnr
wtw: hhu sev
dtk: cpq ykt ufu gua rwv
mxx: eas aai hdw
ogi: zgg gza
nfy: igk
yfo: nfy vmh tnv lss uym qvo pdw xqe gab
vcj: pgx uug
wix: ogr fnw qsu zfw tnv lju vmh nfy gab srx pdw mrk uym foq cgo yzd
pbd: xbc uit
tvl: non nzr cfr wmf
kdk: oin
oeb: tws
ktu: jak mlk ebj
wzi: pfb pak esp
cfr: vak tsy
oil: xtt jqp qan
tnv: psi puv cvf
yzd: dfi qkc moj wqm
cdp: gza zgg
yug: lro loe xhd bdd
mve: qub wfy mqq
gwh: gih xgo
mum: vch
vdu: jcl rhw frk ose
viq: asb vqv
kcn: ldx pak esp
yqy: qzo zbr
ywx: wix wti yfo
zud: fdr qml
ryz: mve
lcd: gjl exl lki khv
igi: cqy
sbg: bvs aos hwx
axe: frt vhw yjl mrl yld
cxv: diu vsr
oxd: waj xzo
fae: nkv
ifg: pyu
gzm: ptx tik
iej: eif
hhh: wvi qux qin
frt: rfk dyl hli
zrf: out
qnj: uit daj xbc wim
udg: rhw ose jcl
qux: nai
eay: rvo qsy
obg: sla pku
you: iej bve wvb qnj zfe tvb gyw nng ria vtx
tss: aec scq wvm gwh
xbo: wix yfo ngu
kuq: fvd
hkv: vpt rye
eqe: cfw
luu: pur byt
cgo: rla igk pwm
upg: icy lhi
dem: row ogo
yld: rzx iic dyl rfk
wjx: xip wvm
axq: you
mpc: vgm
uwe: hqe
xpm: xgo
hdw: znh utm vch lcd
oeq: qub wfy mqq
hzh: uvi nmh cay
awn: drd wnx kdk
ceb: hhh cby
pli: luu
mrl: dyl rzx hli iic rfk
ixj: ggt ojl
cew: rtm unt wsf gjk oxc
prx: nai hhm
vqv: oto
dmk: mth
gga: kyc pgx bmb lja
nzr: vak ogi
jak: iaa oeb kbl nga xye ptr zsl uwe gad kuq
dea: krr mxx
dul: ngo ewh yub evb
kve: wix
dwv: ttg
gad: ewy
hfy: ebj mlk jak
fvo: jab
adm: yld vhw
xbc: tay oga
tek: moj wqm vjz qkc
muc: ifj zrf
drd: cay uvi haz
bwm: rix
zrg: qaq hqj yyc
bzk: ceb bxk ups
kbl: mxx krr
pdw: cxv gho
khd: drd xei hzh
hck: vuu eqj xxv
eao: vld byk upg
ria: xbc wim uit daj
lxt: nxq bxk ceb
znh: khv lki gjl
ieu: gza eee
gho: diu
sra: nxk
pfo: slr
olb: lrd pet cdp
vsr: row
pak: xgo gih
pyu: xft fif xbo
npu: pyu vsj sna
ewy: aai hdw mum eas
wvi: wvj
ogm: uyo avl bec
djp: iek ulx kve
txj: tlm hyq afu tgq
waj: ujn
lhi: wrg
qvj: yfo wti ngu
zfd: ngo yub
ogo: afd vzc xpm
mvz: lxt eif liz
oin: eee
wrg: rid qfg
srx: cha wjx krk tss
vsd: vsj
dcl: zqg xsz
mcg: adr drw
tsy: zgg gza eee
lul: lhi icy
lja: xxn tjf
cte: zfd
xes: dzb yim
qqv: eee gza
bbp: kvw mxg
vld: lhi icy
tvj: ssi hck irg
ktv: hkv mvb
drw: woo mfh
ybu: mve cqy bja oeq jab
rhw: you qfg rid
kzr: adr drw kmy pwt
nai: out
dmm: xsz
nxk: ing
ujn: dta jjc
lze: tik zmt ptx
yqj: ebj zil jak
gge: eso ndn eqo fdr
ulx: wix yfo ngu wti
zqv: gza eee zgg
the: ngu yfo
tvb: nxk oyl
vpj: gih vgm
pah: nzr non cfr ovr
xto: leo ogm zbr
cfw: xjk bdd xhd loe
qaq: nvy heu axq
xgo: jzv sbg qgn lin yxr fvo usu fae dnw iat cvt mcg
sub: ngo ewh evb
mxh: wix wti yfo
svr: aln vua qdf wea
ojl: mak iom fxi
rix: vuj fmr wql onu
uym: wjx
pet: eee gza
hhm: out
uxw: prx qux
mfh: vrq
nsd: pzj oiu
iat: nkv lwz htb jnn
qnr: vgm gih
hdj: egn oyu xsz
bmb: tjf the xxn
exl: gza
sev: out
vyr: eqj cgb vuu
xhd: mlk
vua: rtg yzb gbt qbx bri hdj gzm lze wfc
ufu: out
vza: qqv
rfk: you
ngu: tek ogr fnw zfw lss lju nfy gab xqe srx qvo mrk foq cgo yzd
wmf: tsy
tlm: mto msh
fdr: nwm jom rox
jhr: wix wti
gye: dwv
hzf: jak mlk
hqk: upg lul
psi: sjy mpc skp qnr
kds: jnn htb mnh
bdd: ebj jak
msh: tgc eqh
ztc: qfg you
opy: jak zil mlk
xgd: arp pli
kqt: wdx muc
vmh: igk
bri: eso eqo fdr qml
jqp: tnb qre
puv: qnr
gua: out
ykt: out
hws: hqk
afu: msh
xzx: onu wql vuj fmr
loe: ebj zil jak
byt: wix yfo wti ngu
gxa: jhr pur mxh
iic: you qfg rid
jnn: gcp
qdf: tmm gzm viq nmp gge ito yzb txj qvm gbv fkr
iek: yfo ngu wti
eas: vch znh
yrw: yld yjl vhw mrl
krr: hdw mum eas
pur: yfo ngu wti
qkc: qzj ldb
xjk: ebj
nkp: fcf fbx tmq jgw
kqz: blq nwa
kaa: mkh muc wdx
jgw: jak
tnb: cdp pet
new: gwh
row: cgr vzc
awt: qsq uoc oii
ups: cby uxw hhh
ldx: xgo
lwz: gcp wwb
yim: gua ufu
liz: bxk ceb nxq cxc
kdx: ugy
svy: rqa
vpt: wtw dei blq nwa
lju: tss krk new wjx cha
kla: mls zch
fvt: vdu mqe bqe jib
rrn: hqk
oiu: tvj wsc dlr nhs aoy
dqk: you qfg rid
xtt: olb
wea: eze lze wfc ito zud gge gbv nmp xgd
cay: zgg
lki: eee gza zgg
sxw: oii uoc qvj ywx qsq
blq: hhu sev viw
vna: pny waj
fnr: yqy djz
lky: ing lue
fif: wix yfo wti ngu
avl: dzb dtk uar
bog: gih
ggt: iom
woo: yug
mkh: ifj hsy
sla: sew okc vym tvl pah
yft: vym tvl
wql: wix
fvr: qfg rid
wvm: vgm
bec: dtk
fsg: ngu yfo
mqq: yeh hzf yqj
pny: boo dac
hwx: rxt fwj
eqh: kve
hpt: vpj xpm cgr
qub: hzf yeh jko yqj
lrd: gza
qgn: lwz mnh jnn
xxn: wti wix
rtg: emt
ing: ugy kqt
oyu: ifg hlb gcu npu
emt: msh gkb
mlk: kuq vwd yip zsu obg khd xye aqu iaa oeb abx nsd
yzo: rid you qfg
qxp: ktu qwd
skp: gih xgo vgm
pfb: gih xgo
mak: out
zsl: oiu
evb: yyc
fkr: ybs egn xsz
nmt: xjk
hfc: lth
gbt: arp asb pli
adr: zjj eqe
onu: wti ngu
asb: luu olq gxa oto
leo: uyo avl xes
fbx: zil mlk ebj
lin: kvw
gvw: fnv eqh tgc
oyl: lue kdx ing
tws: tvj nhs
ito: eqo ndn
fwj: jgw tmq fbx
hsy: out
zgg: hws poa cte nzw adg pbl lbp zyn ngn dqh svy uhj ycd oxd
wnx: uvi
vym: ovr
orb: qan jqp
vhw: rzx
bhj: pny xzo
djz: zbr qzo ogm leo
ngn: yiq dul sub zfd
oii: wix ngu wti yfo
wim: eay
vwc: wix yfo ngu wti
sna: xft xbo
rla: ssc cew fft
lth: qwd jpa ktu
gcu: sna vsj
lsy: hzh kdk drd xei
qsq: wix
ndn: pzk jom rox
aec: vgm gih
qin: wvj hhm nai
yyc: heu ztc ryk axq
usu: oeq
pku: okc
hqj: axq ryk heu ztc
qfg: rrz nng fnr bve iej voo mvz tvb pbd
mtc: vgm xgo
uqe: hfc guo kvw mxg
dyl: rid qfg
rrz: lxt
kqr: hfy opy
tik: xzx rix nhi
nwa: viw sev
eue: wvi prx
bxk: eue
sew: nzr ovr
rtm: udu mtc
vch: exl
uyo: yim uar dtk dzb
vuj: yfo
vgm: mcg ryz bbp iat fvo usu dnw yxr igi kds ybu ikk
zyg: qnr mpc mui
zsu: kdk xei
fmr: ngu yfo wix
guo: bfp qxp hoz
ssc: oxc wsf gjk rtm
esp: vgm gih
tgc: iek kve ulx
rid: sra fnr ria vtx rrz pfo wfj zfe tvb pbd voo bve wvb mvz qnj nng bif dmk iej
zfe: lky
yeh: ebj zil jak
wvj: out
dgq: bwm
eva: dem vsr diu
htb: gcp wwb
sjy: vgm
paz: sev hhu viw
nmp: fmm vcj gga
bqe: ose rhw
baq: rlf axe yrw
gih: dnw mcg fae fvo uqe ryz kds sbg kzr ikk
nwm: awt sxw dop hfk
unt: udu mtc
ugy: wdx mkh
qjs: zgg
pbl: eao hqk
diu: hpt row
yma: waj xzo
egn: vsd gcu npu
wfj: lxt liz eif bzk
viw: out
lnz: bqe mqe jib
uar: rwv gua ufu
ikk: mnh nkv htb
ogr: rla
nga: tws pzj oiu
ifj: out
nkv: gcp kla
mvb: rye cxu kqz
uit: oga
kvw: hoz qxp bfp lth
rwv: out
ujb: iek ulx
boo: bea
tay: ixj xqi
fcf: ebj mlk
krk: scq
heu: qfg you
wti: ogr qsu zfw lss tnv vmh nfy lju gab srx qvo pdw uym yzd
gza: dqh lbp nzw fvt xlp cte poa ycd tmj rrn
nhi: onu vuj fmr
mxv: pak ldx
scq: xgo gih vgm
iaa: yft djj sla
zbr: avl bec xes
jko: mlk
bfp: jpa
aoy: ssi hck plv irg
foq: zyg rnr psi puv
dop: uoc
eif: nxq cxc
icy: yzo wrg fvr
mxg: hoz bfp qxp
vtx: eif lxt
uvi: zgg eee gza
cxc: hhh
gcp: mls kqr zqz zch
mls: hfy
lro: jak
lue: kaa ugy
gjl: gza
dnw: bvs
dqh: eao oad hqk
yjl: dyl iic
xxv: zgg eee
rzx: qfg
aai: znh utm lcd
qml: nwm pzk
wdx: ifj zrf
okc: non wmf ovr cfr
fft: oxc gjk wsf unt rtm
bja: wfy qub
eqj: eee
mth: oga eay
kyc: vwc fsg tjf the xxn
wwb: zch kqr
ycd: xso baq fep rqa
djj: sew okc vym pah tvl
zmt: nhi rix
ptr: qan jqp
dei: hhu
qzj: esp pfb pak
cxu: dei blq nwa paz
hfk: ywx qvj oii
adg: udg mqe
yip: yft sla
xip: gih
ebj: rht vwd lsy oil gad khd orb nga nsd oeb zsu awn kuq yip uwe dea ptr aqu xye abx
mrk: krk wjx new
vsj: fif xbo
tmq: ebj zil jak
vor: zgg gza
jzv: aos hwx
aqu: krr mxx ewy
rxt: fbx fcf
lss: cxv eva gho
xqe: eva
hqe: qjs ieu
jib: ose frk
xso: rlf adm
irg: eqj xxv cgb vuu
ybs: vsd npu ifg hlb
cqy: mqq
gjk: bog
wsf: bog
lbp: baq rqa
eze: qml fdr eqo eso
nzw: dul
afd: vgm gih
pzk: sxw awt
gkb: tgc
cpq: out
xzo: boo
byk: gax
ptx: xzx
rox: sxw awt hfk
tgq: gkb
dzb: cpq ufu ykt
xye: xtt
rnr: mui
pgx: fsg vwc xxn the
rqa: yrw
ovr: vak zqv
poa: fep
khv: gza eee zgg
vzc: vgm xgo
quu: rix xzx
hyq: gkb msh gvw mto
wfy: jnz yeh jko yqj
bpy: cxu
rht: tio fvd vza
wvb: nxk oyl lky
jab: qub
bea: tow dqk
hoz: jpa
stb: nmt vrq cfw
cvt: adr pwt
tjf: yfo wti ngu
nhs: ssi hck vyr
cgb: zgg gza eee
tow: rid qfg you
vuu: zgg
vrq: xhd
qbx: hyq emt
fep: axe adm yrw
fvd: qjs uzk
wqm: ldb mxv
fnw: gho
jcl: rid
uoc: ngu
utm: gjl exl lki khv
pwt: eqe stb
fnv: iek ulx
yub: hqj qaq
ryk: rid
ewh: yyc
oga: ixj xqi gye
jom: hfk
eqo: rox jom nwm
nmh: zgg gza eee
ngo: hqj qaq
igk: ssc cew fft
ttg: out
jpa: jak zil
qvo: rla pwm igk
non: vak ogi
uhj: sub dul zfd yiq
udu: xgo
qzo: uyo bec xes
eso: pzk nwm rox
arw: ebj zil
zqz: opy arw
dfi: kcn ldb wzi mxv
bve: zvl ktv
mnh: gcp
ldb: esp pak ldx
olq: mxh
oad: vld upg byk lul
wfc: quu
dta: dqk ixo tow gyt
nxq: uxw hhh cby
zvl: mvb hkv bpy
tio: ieu qqv uzk vor
abx: djj yft pku
xft: wix ngu yfo
nvy: you
cha: gwh aec scq
fmm: kyc
qan: tnb qre
yxr: adr pwt
ose: rid qfg you
rye: wtw nwa blq paz
arp: luu olq gxa oto
gyw: djz yqy
mqe: ose
moj: kcn wzi ldb qzj mxv
haz: eee gza
nng: slr ktv zvl
hhu: out
zyn: vdu mqe udg bqe
zjj: vrq cfw yug
cgr: gih vgm
xlp: xso baq rqa
zqg: hlb ifg npu
ssi: cgb vuu
jnz: jak ebj mlk
qsy: ggt
voo: zvl slr
iom: out
ixo: qfg
xsz: gcu vsd
gyt: rid you
rlf: frt vhw yjl
plv: eqj cgb vuu
tmj: yiq zfd
bvs: rxt
vak: eee zgg
oto: pur byt
xei: cay oin uvi
pwm: fft
